23. C
24. A
25. C
26. B
27. D
28. C (not A)
29. C
30. C (B?)
31. D
32. D
33. D (C?)
34. A (B)
28,29,30,31,32,33,34 ошибки

(Старый вариант)
23. C
24. C
25. C
26. B
27. D
28. A
29. C
30. B
31. D
32. A
33. C
34. D


look through - просматривать
look for - искать 
look around - осмотреться
look across - посмотреть через

Wag - жена спортсмена

time off - отгул, отпуск, свободное время
holidays - каникулы, выходные, нерабочие дни
days off - выходные дни, нерабочие дни
vacation - отпуск, отдых, каникулы

glossy - глянцевый, блестящий
bright - яркий, светлый, блестящий
glam - шикарную, эффектную
sparkling - блестящий, искрящийся

star gazer - астролог, мечтатель
star struck - испытывающий благоговение перед знаменитостью
star fever - звездная болезнь
star worship - поклонение звездам

tolerable - приличный
simply - простой
pitiable - жалкий
ordinary - обычный

could - мог 
must - должен
was able - смог бы
should - следует

to ratify - одобрять, санкционировать; утверждать; скреплять (подписью, печатью)
to examine - рассматривать, осматривать, исследовать, опрашивать
to verify - проверять, контролировать, подтверждать, удостоверять
to check - отметить, проверить

took out - вынимать, удалять, забирать, вести кого то
picked - отобранный, подобранный; собранный, выбранный, отборный
elected - избирать, назначать, делать назначения, выбирать, решать, принимать решение; предпочитать, делать выбор
picked up - сниматься, подбирать, принимать, выбирать

was down for - принять участие, выставить свою кандидатуру, подписаться
was down to - взяться за дело, к самому главному, оказаться, спуститься, перейти к сути, исчерпать
was down with - грохнуться, запивать, страдать, быть одобренным кем-либо, тащить за собой
was down on - находиться в тяжелом положении, в беде, в несчастье, немедленно, сразу

shot - выстрел, снимок, рамка
show - шоу, выставка, показ
art - выставка, искуство
view - показ, презентация

for - 
off - 
over - 
of - 

confession - признание, исповедь, вера
safety - безопасность
commendation - благодарность, рекомендация, одобрение, похвала
credibility - убедительность, вера, способность поверить, надежность